NO      ./textures/eagle.xpm


SO ./textures/greystone.xpm
EA ./textures/red.xpm
WE ./textures/purpleston.xpm

C 255,20 ,             30                  

F  255, 0, 255

        111111111111111111111                111111111111111111111111111111
111111111000100000000000011101
100000000000000000111000100011
110000100000000000000000001111111111
100001111111000000010000111111         1
111111100000000000000001000001 11111111111111111111111111  11111
11111111111111111111111111111111111111111111111111111111111111
                                 1111000000000011000000010001
111111111111111111111111111111111111111111111111111111111111111   1
10000000000000000000000000000111111      11111111111111111111111111111
110000000000011110000000000011
1111111111111    111111111111111111111
111111111111111111111111111111111111

111111111111111111111111111111
100000000000111000000000000011
11000000000011100000000000111
110000000001111000000000000111
111111111111111111111111111111111
        100000000001
         1000000001
          10000001
           100001
            1001
             11
1
  1
11W1
  1





1111111

