NO      ./texture/north.xpm
SO ./texture/south.xpm
EA ./texture/east.xpm
WE ./texture/weast.xpm

C 0, 255, 255 
F  11, 11, 11



111111111111111111111111111111
111111111000100000000000011111
10000000000000000E111000100001
110000100000000000000000001111
100001111111000000010000111111
111111100000000000000000000001
111100000000001100000001000011
100000000000000000000000000001
110000000000011110000000000011
100000000000111000000000000011
11000000000011100000000000111
110000000001111000000000000111
111111111111111111111111111111111
