C 255,20 ,30
NO      ./textures/eagle.xpm
SO ./textures/greystone.xpm
EA ./textures/red.xpm
WE ./textures/purplestone.xpm

S ./textures/tonneau.xpm
F  000, 000, 00



111111111111111111111111111111
111111111000100000000000011111
100000000000000000111000100001
1100001000000000W0000000001111
100001111111000000010000111111
1111111000000000W0000000000001
111100000000001100000001000011
100000000000000000000000000001
110000000000011110000000000011
100000000000111000000000000011
1100000000001110S000000000111
110000000001111000000000000111
111111111111111111111111111111111
