NO      ./textures/eagle.xpm
SO ./textures/greystone.xpm
EA ./textures/red.xpm
WE ./textures/purplestone.xpm

C 255,20 ,30
F  000, 000, 00



111111111111111111111111111111
111111111000100000000000011111
100000000000000000111000100001
110000100000000000000000001111
100001111111000000010000111111         1
111111100000000000000000000001 111111110111111111111111111
111100000000001100000001000011         1
100000000000000000000000000001
110000000000011110000000000011
100W00000000111000000000000011
11000000000011100000000000111
110000000001111000000000000111
111111111111111111111111111111111
                                
 1
