C 255,20 ,30
NO      ./textures/eagle.xpm
SO ./textures/greystone.xpm
EA ./textures/red.xpm
WE ./textures/purplestone.xpm

S ./textures/tonneau.xpm
F 000,  000, 00
N
E
W
                        
                       111111
                       100001
                       100001
                       100001
                       100001
                       100001
                       100001
                       100001
1111111111111111111111110000111111111111111111111111
1000000000000000000000000000000000000000000000000001
1W00000000000000000000111111000000000000000000000001
10000000000000000000001    1000000000000000000000001
10000000000000000000001    1000000000000000000000001
1000000000000000000000111111000000000000000000000001
1000000000000000000000000000000000000000000000000001
1000000000000000000000000000000000000000000000000001
1111111111111111111111110000111111111111111111111111
                       100001
                       100001
                       100001
                       100001
                       100001
                       100001
                       100001
                       100001
                       100001
                       100001
                       100001
                       100001
                       100001
                       111111
