NO      ./textures/eagle.xpm
SO ./textures/greystone.xpm
EA ./textures/red.xpm
WE ./textures/purplestone.xpm

C 255,20 ,30
F  000, 000, 00



111111111111111111111111111111
111111111000100000000000011111
100000000000000000111000100001
110000100000000000000000001111
10000111111100000001000011111
111111100000000000000000000001
111100000000001100000001000011
100000000000000000000000000001
110000000000011110000000000011
100000000000111000000000000011
11000000000011100000000000111
110000000001111000000000000111
11111111111111111111S111111111111
